com.android.browser	ActivityInfo{3f53b4f com.UCMobile.main.UCMobile
com.android.calendar	ActivityInfo{59682dc com.android.calendar.AllInOneActivity
com.android.contacts	ActivityInfo{f1cefe5 com.android.contacts.activities.PeopleActivity
com.android.contacts	ActivityInfo{881aba com.android.contacts.activities.DialtactsActivity
com.android.deskclock	ActivityInfo{7f43d6b com.android.deskclock.AlarmsMainActivity
com.android.email	ActivityInfo{976f0c8 com.android.email.activity.Welcome
com.android.gallery3d	ActivityInfo{7b1a561 com.huawei.gallery.app.GalleryMain
com.android.mediacenter	ActivityInfo{10d2886 com.android.mediacenter.PageActivity
com.android.mms	ActivityInfo{2974547 com.android.mms.ui.ConversationList
com.android.settings	ActivityInfo{d6e5174 com.android.settings.HWSettings
com.example.android.notepad	ActivityInfo{882369d com.example.android.notepad.NotePadActivity
com.huawei.android.findmyphone	ActivityInfo{6834712 com.huawei.android.findmyphone.ui.FindMyPhoneActivity
com.huawei.android.tips	ActivityInfo{f78eee3 com.huawei.android.tips.DrawerDisplayActivity
com.huawei.camera	ActivityInfo{5d910e0 com.huawei.camera
com.huawei.gamebox	ActivityInfo{dd09f99 com.huawei.gamebox.GameBoxActivity
com.huawei.hidisk	ActivityInfo{bcac25e com.huawei.hidisk.filemanager.FileManager
com.huawei.himovie	ActivityInfo{f41963f com.huawei.himovie.ui.login.SplashScreenActivity
com.huawei.hiskytone	ActivityInfo{e6e5b0c com.huawei.skytone.account.welcome.SplashActivity
com.huawei.hwireader	ActivityInfo{c029c55 com.chaozh.iReader.ui.activity.WelcomeActivity
cn.kuwo.player	ActivityInfo{77ca66a cn.kuwo.player.activities.EntryActivity
com.achievo.vipshop	ActivityInfo{ac3575b com.achievo.vipshop.activity.LodingActivity
com.android.chrome	ActivityInfo{52c1bf8 com.google.android.apps.chrome.Main
com.baidu.BaiduMap	ActivityInfo{e1da8d1 com.baidu.baidumaps.WelcomeScreen
com.baidu.appsearch	ActivityInfo{eb6bf36 com.baidu.appsearch.LauncherActivity
com.chaozh.iReaderFree	ActivityInfo{bd60e37 com.chaozh.iReader.ui.activity.WelcomeActivity
com.dangdang.buy2	ActivityInfo{802ffa4 com.dangdang.buy2.StartupActivity
com.google.android.apps.maps	ActivityInfo{3010d com.google.android.maps.MapsActivity
com.iflytek.inputmethod	ActivityInfo{8a798c2 com.iflytek.inputmethod.LauncherActivity
com.ophone.reader.ui	ActivityInfo{7f356d3 com.cmread.bplusc.bookshelf.LocalMainActivity
com.pingan.papd	ActivityInfo{1427210 com.pingan.papd.ui.activities.JKLogoActivity
com.qihoo.appstore	ActivityInfo{6ba109 com.qihoo.appstore.home.LauncherActivity
com.sohu.inputmethod.sogou	ActivityInfo{eda7f0e com.sohu.inputmethod.sogou.SogouIMELauncher
me.ele	ActivityInfo{8928d2f me.ele.Launcher
cn.wps.moffice_eng	ActivityInfo{ec49f3c cn.wps.moffice.documentmanager.PreStartActivity
com.android.calculator2	ActivityInfo{6a444c5 com.android.calculator2.Calculator
com.android.documentsui	ActivityInfo{6437e1a com.android.documentsui.LauncherActivity
com.android.hwmirror	ActivityInfo{d44cd4b com.android.hwmirror.Mirror
com.android.soundrecorder	ActivityInfo{fda7328 com.android.soundrecorder.SoundRecorder
com.android.stk	ActivityInfo{8096841 com.android.stk.StkLauncherActivity
com.android.stk	ActivityInfo{d0b61e6 com.android.stk.StkLauncherActivity2
com.android.systemui	ActivityInfo{390f327 com.android.systemui.flashlight.FlashlightActivity
com.autonavi.minimap	ActivityInfo{5f799d4 com.autonavi.map.activity.SplashActivity
com.baidu.searchbox	ActivityInfo{943477d com.baidu.searchbox.SplashActivity
com.hicloud.android.clone	ActivityInfo{91bb672 com.huawei.android.clone.activity.sender.ChooseRecevieSendActivity
com.huawei.KoBackup	ActivityInfo{8f9ac3 com.huawei.KoBackup.InitializeActivity
com.huawei.android.hwouc	ActivityInfo{41e7f40 com.huawei.android.hwouc.ui.activities.MainEntranceActivity
com.huawei.android.remotecontroller	ActivityInfo{741de79 com.huawei.android.remotecontroller.StartActivity
com.huawei.android.thememanager	ActivityInfo{36ac7be com.huawei.android.thememanager.HwThemeManagerActivity
com.huawei.android.totemweatherapp	ActivityInfo{847201f com.huawei.android.totemweatherapp.WeatherHome
com.huawei.appmarket	ActivityInfo{90c4f6c com.huawei.appmarket.MainActivity
com.huawei.compass	ActivityInfo{3f8e935 com.huawei.compass.MainActivity
com.huawei.fans	ActivityInfo{c07a1ca com.huawei.fans.activity.MainActivity
com.huawei.gameassistant	ActivityInfo{ec79f3b com.huawei.gameassistant.views.LoadActivity
com.huawei.health	ActivityInfo{24f658 com.huawei.health.MainActivity
com.huawei.hwvplayer.youku	ActivityInfo{2dbe3b1 com.huawei.hwvplayer.framework.MainActivity
com.huawei.lives	ActivityInfo{2e61096 com.huawei.lifeservice.basefunction.ui.entry.LandingActivity
com.huawei.phoneservice	ActivityInfo{f06f417 com.huawei.phoneservice.LaunchActivity
com.huawei.smarthome	ActivityInfo{51f2004 com.huawei.smarthome.login.LauncherActivity
com.huawei.systemmanager	ActivityInfo{11a09ed com.huawei.systemmanager.mainscreen.MainScreenActivity
com.huawei.trustspace	ActivityInfo{16aa022 com.huawei.trustspace.mainscreen.LoadActivity
com.huawei.vassistant	ActivityInfo{37cbab3 com.huawei.vassistant.ui.main.VAssistantActivity
com.huawei.vdrive	ActivityInfo{6703870 com.huawei.vdrive.ui.VDriveActivity
com.huawei.wallet	ActivityInfo{59a57e9 com.huawei.wallet.view.MainActivity
com.ifeng.news2	ActivityInfo{b69c6e com.ifeng.news2.activity.SplashActivity
com.microsoft.translator	ActivityInfo{c7e4f0f com.microsoft.translator.activity.SplashActivity
com.sankuai.meituan	ActivityInfo{2786b9c com.sankuai.meituan.activity.Welcome
com.sina.weibo	ActivityInfo{4b789a5 com.sina.weibo.SplashActivity
com.stupeflix.replay	ActivityInfo{8b4117a com.stupeflix.replay.features.home.HomeActivity
com.vmall.client	ActivityInfo{5acd2b com.vmall.client.splash.fragment.SplashActivity
ctrip.android.view	ActivityInfo{b6ea588 ctrip.business.splash.CtripSplashActivity
air.tv.douyu.android	ActivityInfo{3bc1b21 tv.douyu.view.activity.SplashActivity
android.zhibo8	ActivityInfo{3e1cb46 android.zhibo8.ui.contollers.main.LaunchActivity
bubei.tingshu	ActivityInfo{1371107 bubei.tingshu.ui.LOGOActivity
cmb.pb	ActivityInfo{e0c9234 cmb.pb.ui.PBInitActivity
cn.amazon.mShop.android	ActivityInfo{81e485d com.amazon.mShop.home.HomeActivity
cn.cntv	ActivityInfo{3df55d2 cn.cntv.ui.activity.SplashActivity
cn.com.spdb.mobilebank.per	ActivityInfo{4a9b6a3 cn.com.spdb.mobilebank.per.activity.SplashActivity
cn.eclicks.wzsearch	ActivityInfo{6fa9da0 cn.eclicks.wzsearch.ui.StartPageActivity
cn.etouch.ecalendar	ActivityInfo{e7c0d59 cn.etouch.ecalendar.ECalendar
com.A17zuoye.mobile.homework	ActivityInfo{2b8fd1e com.A17zuoye.mobile.homework.main.activity.WelcomeActivity
com.MobileTicket	ActivityInfo{91719ff com.MobileTicket.MobileTicket
com.Qunar	ActivityInfo{2fbf3cc com.mqunar.splash.SplashActivity
com.UCMobile	ActivityInfo{5572615 com.UCMobile.main.UCMobile
com.alibaba.android.rimet	ActivityInfo{cf3cd2a com.alibaba.android.rimet.biz.SplashActivity
com.alibaba.wireless	ActivityInfo{4cd571b com.alibaba.wireless.v5.LauncherActivity
com.android.bankabc	ActivityInfo{5da80b8 com.android.bankabc.SplashActivity
com.android.dazhihui	ActivityInfo{7910e91 com.android.dazhihui.dzh.dzh
com.anjuke.android.app	ActivityInfo{5991f6 com.anjuke.android.app.WelcomeActivity
com.autohome.mycar	ActivityInfo{ae049f7 com.autohome.mycar.module.ad.AdActivity
com.autonavi.xmgd.navigator	ActivityInfo{412f064 com.autonavi.xmgd.navigator.Warn
com.babytree.apps.pregnancy	ActivityInfo{2a702cd com.babytree.apps.pregnancy.MainActivity
com.baidu.browser.apps	ActivityInfo{b84d782 com.baidu.browser.framework.BdBrowserActivity
com.baidu.lbs.waimai	ActivityInfo{1c58e93 com.baidu.lbs.waimai.SplashActivity
com.baidu.netdisk	ActivityInfo{b40aed0 com.baidu.netdisk.ui.Navigate
com.baidu.tieba	ActivityInfo{4adfec9 com.baidu.tieba.LogoActivity
com.baidu.video	ActivityInfo{a2ce9ce com.baidu.video.ui.WelcomActivity
com.bankcomm.Bankcomm	ActivityInfo{7b080ef com.bankcomm.config.ConfigActivity
com.bankcomm.maidanba	ActivityInfo{549e7fc com.bankcomm.maidanba.activity.SplashActivity
com.changba	ActivityInfo{e0ebe85 com.changba.splash.Welcome
com.chinamworld.bocmbci	ActivityInfo{a31d4da com.chinamworld.bocmbci.biz.DexActivity
com.chinamworld.main	ActivityInfo{ae3d0b com.ccb.start.CcbSplashActivity
com.cmbchina.ccd.pluto.cmbActivity	ActivityInfo{24b87e8 com.cmbchina.ccd.pluto.cmbActivity.SplashActivity
com.ct.client	ActivityInfo{301be01 com.ct.client.SplashActivity
com.dianping.v1	ActivityInfo{56864a6 com.dianping.main.guide.SplashScreenActivity
com.didi.echo	ActivityInfo{a819ee7 com.didi.echo.bussiness.splash.SplashActivity
com.dp.android.elong	ActivityInfo{5453a94 com.elong.activity.others.AppGuidActivity
com.duowan.kiwi	ActivityInfo{8cb393d com.duowan.kiwi.simpleactivity.SplashActivity
com.duowan.mobile	ActivityInfo{c262532 com.yy.mobile.ui.splash.SplashActivity
com.eastmoney.android.berlin	ActivityInfo{23f4283 com.eastmoney.android.berlin.activity.MainActivity
com.eg.android.AlipayGphone	ActivityInfo{f856c00 com.eg.android.AlipayGphone.AlipayLogin
com.example.businesshall	ActivityInfo{ab72c39 com.businesshall.activity.NewLogoActivity
com.example.sendbroadcasttohwiaware	ActivityInfo{c8d627e com.example.sendbroadcasttohwiaware.MainActivity
com.example.zkfzle.myapplication	ActivityInfo{7a983df com.example.zkfzle.myapplication.MainActivity
com.fanli.android.apps	ActivityInfo{6d5482c com.fanli.android.basicarc.ui.activity.SplashActivity
com.fenbi.android.solar	ActivityInfo{2d552f5 com.fenbi.android.solar.activity.SplashActivity
com.flightmanager.view	ActivityInfo{299288a com.flightmanager.view.Loading
com.ganji.android	ActivityInfo{a4c7efb com.ganji.android.home.activity.LaunchActivity
com.gotokeep.keep	ActivityInfo{264bb18 com.gotokeep.keep.activity.SplashActivity
com.gtgj.view	ActivityInfo{2752971 com.gtgj.view.LaunchActivity
com.handsgo.jiakao.android	ActivityInfo{ce94356 com.handsgo.jiakao.android.splash.Login
com.hexin.plat.android	ActivityInfo{c5a0fd7 com.hexin.plat.android.AndroidLogoActivity
com.hunantv.imgo.activity	ActivityInfo{a7670c4 com.hunantv.imgo.activity.MainActivity
com.icbc	ActivityInfo{661ebad com.icbc.activity.init.LoadingActivity
com.icbc.im	ActivityInfo{24e3ee2 com.icbc.im.SplashActivity
com.intsig.camscanner	ActivityInfo{745d273 com.intsig.camscanner.WelcomeActivity
com.jd.jrapp	ActivityInfo{6cbd530 com.jd.jrapp.WelcomeActivity
com.jingdong.app.mall	ActivityInfo{2de95a9 com.jingdong.app.mall.main.MainActivity
com.jiongji.andriod.card	ActivityInfo{415672e com.baicizhan.main.activity.LoadingPageActivity
com.jm.android.jumei	ActivityInfo{e2122cf com.jm.android.jumei.home.activity.StartActivity
com.jsmcc	ActivityInfo{7d1145c com.jsmcc.ui.WelcomeActivity
com.jxedt	ActivityInfo{361e365 com.jxedt.ui.activitys.GuideActivity
com.kingpoint.gmcchh	ActivityInfo{914c83a com.kingpoint.gmcchh.newui.main.skeleton.view.SkeletonActivity
com.kingsoft	ActivityInfo{9b71ceb com.kingsoft.StartActivity
com.kugou.android	ActivityInfo{6891a48 com.kugou.android.app.splash.SplashActivity
com.letv.android.client	ActivityInfo{a1250e1 com.letv.android.client.activity.SplashActivity
com.lphtsccft	ActivityInfo{d772e06 com.lphtsccft.zhangle.startup.SplashScreenActivity
com.meelive.ingkee	ActivityInfo{a689cc7 com.meelive.ingkee.business.commercial.launcher.ui.IngkeeLauncher
com.meitu.meipaimv	ActivityInfo{73992f4 com.meitu.meipaimv.StartupActivity
com.meitu.meiyancamera	ActivityInfo{b021a1d com.meitu.meiyancamera.MyxjActivity
com.meitu.wheecam	ActivityInfo{3482492 com.meitu.wheecam.WheeCamStartupActivity
com.mobike.mobikeapp	ActivityInfo{bc83e63 com.mobike.mobikeapp.SplashActivity
com.mogujie	ActivityInfo{ad6ea60 com.mogujie.home.MGInitAct
com.moji.mjweather	ActivityInfo{f2b3b19 com.moji.mjweather.LauncherActivity
com.mt.mtxx.mtxx	ActivityInfo{fbff7de com.mt.mtxx.mtxx.TopViewActivity
com.mymoney	ActivityInfo{5f65dbf com.mymoney.biz.splash.SplashScreenActivity
com.netease.cloudmusic	ActivityInfo{b304c8c com.netease.cloudmusic.activity.LoadingActivity
com.netease.mail	ActivityInfo{b2b6fd5 com.netease.mobimail.activity.LaunchActivity
com.netease.newsreader.activity	ActivityInfo{14fb3ea com.netease.nr.biz.ad.AdActivity
com.nuomi	ActivityInfo{8bd16db com.baidu.bainuo.dex.InstallDexActivity
com.p1.mobile.putong	ActivityInfo{ddba578 com.p1.mobile.putong.ui.splash.SplashAct
com.panda.videoliveplatform	ActivityInfo{5c03451 com.panda.videoliveplatform.activity.WelcomeActivity
com.pingan.carowner	ActivityInfo{a6d24b6 com.pingan.carowner.activity.SplashActivity
com.pingan.lifeinsurance	ActivityInfo{c6c45b7 com.pingan.lifeinsurance.basic.initialize.activity.LauncherActivity
com.pingan.paces.ccms	ActivityInfo{9e1a124 com.pingan.pocketbank.splash.PALoadingActivity
com.pplive.androidphone	ActivityInfo{a02c48d com.pplive.androidphone.ui.FirstActivity
com.qihoo.browser	ActivityInfo{d1ed642 com.qihoo.browser.launcher.LauncherActivity
com.qihoo.cleandroid_cn	ActivityInfo{4758653 com.qihoo360.mobilesafe.opti.ui.main.AppEnterActivity
com.qihoo360.mobilesafe	ActivityInfo{c29ab90 com.qihoo360.mobilesafe.ui.index.AppEnterActivity
com.qiyi.video	ActivityInfo{1641c89 com.qiyi.video.WelcomeActivity
com.qq.reader	ActivityInfo{348148e com.qq.reader.activity.SplashActivity
com.qzone	ActivityInfo{fc834af com.tencent.sc.activity.SplashActivity
com.sankuai.meituan.takeoutnew	ActivityInfo{6a5f0bc com.sankuai.meituan.takeoutnew.ui.page.boot.WelcomeActivity
com.sdu.didi.gsui	ActivityInfo{168f845 com.didichuxing.driver.sdk.LauncherActivity
com.sdu.didi.psnger	ActivityInfo{fb4eb9a com.didi.sdk.app.DidiLoadDexActivity
com.shoujiduoduo.ringtone	ActivityInfo{2ed6ccb com.shoujiduoduo.ringtone.activity.WelcomeActivity
com.sina.news	ActivityInfo{63f5ca8 com.sina.news.module.launch.activity.PowerOnScreen
com.sinovatech.unicom.ui	ActivityInfo{925d3c1 com.sinovatech.unicom.ui.WelcomeClient
com.snda.wifilocating	ActivityInfo{3e62766 com.lantern.launcher.ui.MainActivity
com.sohu.newsclient	ActivityInfo{7e40aa7 com.sohu.newsclient.boot.activity.SplashActivity
com.sohu.sohuvideo	ActivityInfo{b819b54 com.sohu.sohuvideo.FirstNavigationActivityGroup
com.soufun.app	ActivityInfo{a7aeafd com.soufun.app.activity.MainSplashActivity
com.ss.android.article.news	ActivityInfo{69d53f2 com.ss.android.article.news.activity.SplashBadgeActivity
com.ss.android.article.video	ActivityInfo{fbcaa43 com.ss.android.article.video.activity.SplashActivity
com.ss.android.essay.joke	ActivityInfo{20718c0 com.ss.android.essay.joke.activity.SplashActivity
com.storm.smart	ActivityInfo{b1039f9 com.storm.smart.LogoActivity
com.szzc.ucar.pilot	ActivityInfo{728bd3e com.szzc.splash.SplashActivity
com.taobao.idlefish	ActivityInfo{1f5a79f com.taobao.fleamarket.home.activity.InitActivity
com.taobao.qianniu	ActivityInfo{2a500ec com.taobao.qianniu.ui.InitActivity
com.taobao.taobao	ActivityInfo{9117cb5 com.taobao.tao.welcome.Welcome
com.taobao.trip	ActivityInfo{96f6f4a com.alipay.mobile.quinox.LauncherActivity
com.telecom.video	ActivityInfo{5971ebb com.telecom.video.ui.activity.LoadingActivity
com.tencent.androidqqmail	ActivityInfo{c573fd8 com.tencent.qqmail.launcher.desktop.LauncherActivity
com.tencent.gallerymanager	ActivityInfo{faa2f31 com.tencent.gallerymanager.ui.main.splash.SplashActivity
com.tencent.karaoke	ActivityInfo{6bd3616 com.tencent.karaoke.module.splash.ui.SplashBaseActivity
com.tencent.map	ActivityInfo{eeb97 com.tencent.map.WelcomeActivity
com.tencent.mm	ActivityInfo{fec8184 com.tencent.mm.ui.LauncherUI
com.tencent.mobileqq	ActivityInfo{7418d6d com.tencent.mobileqq.activity.SplashActivity
com.tencent.mtt	ActivityInfo{f4e9da2 com.tencent.mtt.SplashActivity
com.tencent.news	ActivityInfo{5ccaa33 com.tencent.news.activity.SplashActivity
com.tencent.qqlive	ActivityInfo{a7231f0 com.tencent.qqlive.ona.activity.WelcomeActivity
com.tencent.qqmusic	ActivityInfo{d769369 com.tencent.qqmusic.activity.AppStarterActivity
com.tencent.qqpim	ActivityInfo{89cf1ee com.tencent.qqpim.ui.QQPimAndroid
com.tencent.qqpimsecure	ActivityInfo{89db68f com.tencent.server.fore.QuickLoadActivity
com.tencent.qt.qtl	ActivityInfo{a607d1c com.tencent.qt.qtl.activity.main.LauncherActivity
com.tencent.reading	ActivityInfo{dbfd25 com.tencent.reading.activity.SplashActivity
com.tencent.token	ActivityInfo{46a3efa com.tencent.token.ui.LogoActivity
com.tencent.ttpic	ActivityInfo{fc92cab com.tencent.ttpic.module.MainActivity
com.tencent.wifimanager	ActivityInfo{b864f08 com.tencent.server.fore.QuickLoadActivity
com.thestore.main	ActivityInfo{c7446a1 com.thestore.main.LoadingActivity
com.tmall.wireless	ActivityInfo{c8d50c6 com.tmall.wireless.splash.TMSplashActivity
com.tmri.app.main	ActivityInfo{5ebe887 com.tmri.app.ui.activity.TmriActivity
com.tongcheng.android	ActivityInfo{5b553b4 com.tongcheng.android.LoadingActivity
com.tudou.android	ActivityInfo{eedabdd com.tudou.android.ui.activity.welcome.WelcomeActivity
com.tuniu.app.ui	ActivityInfo{f7db352 com.tuniu.app.ui.homepage.LaunchActivity
com.umetrip.android.msky.app	ActivityInfo{8948623 com.umetrip.android.msky.app.module.startup.SplashActivity
com.ushaqi.zhuishushenqi	ActivityInfo{a2df720 com.ushaqi.zhuishushenqi.ui.SplashActivity
com.videogo	ActivityInfo{99e28d9 com.videogo.login.LoadingActivity
com.wochacha	ActivityInfo{99fb29e com.wochacha.StartupActivity
com.wuba	ActivityInfo{59f617f com.wuba.activity.launch.LaunchActivity
com.xiachufang	ActivityInfo{bcb654c com.xiachufang.activity.StartPageActivity
com.ximalaya.ting.android	ActivityInfo{33f7995 com.ximalaya.ting.android.host.activity.WelComeActivity
com.xunlei.downloadprovider	ActivityInfo{7505aaa com.xunlei.downloadprovider.launch.LaunchActivity
com.xunmeng.pinduoduo	ActivityInfo{252969b com.xunmeng.pinduoduo.ui.activity.MainFrameActivity
com.yek.android.kfc.activitys	ActivityInfo{def8a38 com.yum.brandkfc.SplashAct
com.ygkj.chelaile.standard	ActivityInfo{a6b1a11 dev.xesam.chelaile.app.module.func.SplashActivity
com.yiche.price	ActivityInfo{bb17776 com.yiche.price.LogoSplashActivity
com.yipiao	ActivityInfo{83a0177 com.yipiao.activity.LaunchActivity
com.yongche.android	ActivityInfo{62f11e4 com.yongche.android.YDBiz.Welcome.LoadingActivity
com.youan.universal	ActivityInfo{3d6464d com.youan.universal.ui.activity.SplashActivity
com.youdao.translator	ActivityInfo{8359502 com.youdao.translator.activity.LaunchActivity
com.youku.phone	ActivityInfo{3c33e13 com.youku.phone.ActivityWelcome
com.youloft.calendar	ActivityInfo{cbd6850 com.youloft.calendar.MainActivity
com.zhangdan.app	ActivityInfo{4dfa49 com.zhangdan.app.activities.SplashActivity
com.zhihu.android	ActivityInfo{ebff4e com.zhihu.android.app.ui.activity.MainActivity
dopool.player	ActivityInfo{99a86f dopool.player.SplashActivity
fm.qingting.qtradio	ActivityInfo{798b97c fm.qingting.qtradio.WelcomeActivity
fm.xiami.main	ActivityInfo{672f205 fm.xiami.main.SplashActivity
sina.mobile.tianqitong	ActivityInfo{98cc25a com.sina.tianqitong.ui.main.Splash
tv.acfundanmaku.video	ActivityInfo{fc25c8b tv.acfun.core.view.activity.SplashActivity
tv.pps.mobile	ActivityInfo{c75f168 tv.pps.mobile.WelcomeActivity
vz.com	ActivityInfo{c35a981 com.feeyo.vz.activity.VZLaunchActivity